JSON	JavaScript Object Notation
IoT	Internet of Things
CO	carbon monoxide
VTG	Video Test Generator
SIP	Session Initiation Protocol
IPICS	Internet Protocol Interoperability and Collaboration System
ID	IDENTIFICATION
JSON	JAVA SCRIPT OBJECT NOTATION
CEC	CONSUMER ELECTRONICS CONTROL
APP	APPLICATION
HDMI	High Definition Multimedia Interface
API	APPLICATION PROGRAMMING INTERFACE
MQTT	MESSAGE QUEUING TELEMETRY TRANSPORT
REF	REFERENCE
OPS	OPERATION
ABBR	ABBREVIATION
ABF	APPLICATION-BY-FORMS
ABS	ABSOLUTE
ACC	ACCUMULATOR
ACK	ACKNOWLEDGMENT
ACT	ACCUMULATOR
ADDR	ADDRESS
ADMIN	ADMINISTRATION
ADR	ADDRESS
ADRS	ADDRESS
AH	AMPERE-HOUR
ORIENTED	NETWORK
RETRIEVAL	TECHNIQUE
AMP	AMPERE
AS	ADD/SUBTRACT
.BAS	BASIC
BDH	BEARING
BICARSA	BILLING
BKSP	BACKSPACE
BL	BLANK
BL	BLANKING
BLK	BLOCK
BLNK	BLANK
BMD	BIOMEDICAL
BP	BANDPASS
BSY	BUSY
BTS	BURSTER-TRIMMER-STACKER
BTSP	BOOTSTRAP
BUF	BUFFER
BW	BANDWIDTH
AND	MANUFACTURING
TIME-SHARING	SYSTEM
CONTROL	SYSTEM
CARR	CARRIER
CCT	CIRCUIT
CCW	COUNTER-CLOCKWISE
CD	CARD
NETWORK	ARCHITECTURE
CEPS	CIPS
CHAR	CHARACTER
CHK	CHECK
AND	CONTROL
CIR	CIRCUIT
CK	CHECK
INFORMATION	EXCHANGE
CM	COMMUNICATION
CMCT	COMMUNICATE
CMD	COMMAND
OVER	TCP/IP
CMP	COMPUTATIONAL
CMPLX	COMPLEX
CMPTR	COMPUTER
MANAGEMENT	ASSOCIATIONS
CNTRL	CONTROL
CODEC	CODER-DECODER
COMM	COMMUNICATION
CON	CONTROL
CONS	CONSOLE
REMOTE	TERMINALS
CONST	CONSTANT
CONT	CONTINUE
CONT	CONTINUOUS
CONTROL	SYSTEM
COR	CORRECT
CORR	CORRESPONDENCE
CP	COMPUTER
CPLD	COUPLED
CPLMT	COMPLEMENT
CPTY	CAPACITY
CPY	COPY
CQT	CORRECT
CR	CREDIT
CRYPTO	CRYPTOGRAH
CRYPTO	CRYPTOGRAPHY
CT	COUNTER
CT	COUNT
CTC	CHANNEL-TO-CHANNEL
CTRL	CONTROL
D/T	DISK/TAPE
FOR	COMPUTERS
DB	DECIBLE
DCMT	DOCUMENT
DCMT	DECREMENT
DEC	DECIMAL
DEC	DECISION
DECR	DECREMENT
DEL	DELETE
DEL	DELAY
DEM	DEMODULATOR
DEMO	DEMONSTRATION
DEMOD	DEMODULATOR
DENS	DENSITY
DGNL	DIAGONAL
DGT	DIGIT
DICT	DICTIONARY
DIV	DIVIDER
DLY	DELAY
DLYD	DELAYED
DMUX	DEMULTIPLEX
DOC	DOCUMENT
COMMUNICATIONS	SYSTEM
DPDT	DOUBLE-POLE
DPST	DOUBLE-POLE
DR	DRIVE
DR	DRUM
DSGN	DESIGNATION
DW	DISPLAYWRITE
DX	DISTANCE
DX	DUPLEX
E/M	ELECTRO/MECHANICAL
ENT	ENTRY
EQ	EQUALIZER
EQ	EQUAL
EQ	EQUATE
EQP	EQUIPMENT
EQU	EQUATE
EQU	EQUAL
EQUPMT	EQUIPMENT
ERR	ERROR
EST	ESTIMATE
FOR	EUROPE
EVAL	EVALUATION
EX	EXECUTE
EXAM	EXAMINE
EXCH	EXCHANGE
EXCLU	EXCLUSIVE
EXCP	EXCEPT
EXEC	EXECUTE
EXEC	EXECUTION
EXEC	EXECUTIVE
EXTSN	EXTENSION
F-F	FLIP-FLOP
FAX	FACSIMILE
FHD	FIXED-HEAD-DISK
FIG	FIGURE
FLD	FIELD
FM	FORMAT
FMT	FORMAT
FUN	FUNCTION
GB	GIGABYTE
GEN	GENERATOR
GH	GIGAHERTZ
GHz	GIGAHERTZ
GND	GROUND
GR	GROUP
GRP	GROUP
HB	HANDBOOK
HDG	HEADING
HDX	HALF-DUPLEX
HEX	HEXADECIMAL
HFC	HYBRID-FIBER-COAX
HH	HOURS
HH/MM	HOURS/MINUTES
HS	HANDSET
HZ	HERTZ
IB	ISOBAR
IM	INSTRUMENTATION
PROCESSING	FAMILY
IMD	IMMEDIATE
IN	INPUT
IND	INDICATOR
INF	INFORMATION
INFO	INFORMATION
.INI	INITIALIZATION
INIT	INITIALIZE
INIT	INITIATE
INQ	INQUIRY
INST	INSTRUCTION
INT	INTERRUPT
INT	INITIAL
INT	INTEGER
IR	INFRARED
ISM	INDUSTRIAL
DEVELOPMENT	ENVIRONMENT
IV	INVERTER
IX	INDEX
J/S	JUSTIFIED
JCTN	JUNCTION
JIT	JUST-IN-TIME
KAK	KEY-AUTO-KEY
KB	KEYBOARD
KB	KILOBYTE
LBL	LABEL
LCL	LOCAL
LCZR	LOCALIZER
LD	LOAD
LGNT	LENGTH
LIM	LIMIT
LIT	LITERAL
LMT	LIMIT
LOG	LOGARITHM
LOG	LOGIC
LTL	LITERAL
LTR	LETTER
LWR	LOWER
M-B	MAKE-BREAK
M-D	MODULATION-DEMODULATION
MACRO	MACROINSTRUCTION
MAG	MAGNETIC
MAN	MANUAL
CONTROL	SYSTEM
MAX	MAXIMUM
MB	MEGABYTE
MC	MEGACYCLE
MC	MICROCHANNEL
ME	MICROELECTRONIC
MEM	MEMORY
MF	MAINFRAME
MF	MICROFICHE
MGMT	MANAGEMENT
MGR	MANAGER
MHZ	MEGAHERTZ
MICRO	MICROCOMPUTER
MIN	MINIMUM
MIN	MINUTE
MKS	METER-KILOGRAM/SECOND
MM	MILLIMETER
MMDDYY	MONTH
MOD	MODULATION
MOD	MODULAR
MOD	MODULE
MON	MONITOR
MONO	MONOCHROME
MP	MULTIPROCESSOR
MPL	MULTIPLE
MPU	MULTIPLEX
MPX	MULTIPLEXER
MPY	MULTIPLY
MR	MAGNETORESISTIVE
MRO	MAINTENANCE
MS	MANUSCRIPT
MSEC	MILLISECOND
MSG	MESSAGE
MSK	MASK
MULTI-PROGRAMMING	SYSTEM
MUX	MULTIPLEXER
MV	MILLIVOLT
MX	MATRIX
MX	MULTIPLEX
NEG	NEGATIVE
NIL	NOTHING
NOM	NOMINAL
NR	NUMBER
NS	NANOSECONDS
NUM	NUMBER
OCT	OCTAL
OFC	OFFICE
OFF	OFFICE
OL	ONLINE
OP	OPERATION
OP	OUTPUT
OPN	OPEN
OPND	OPERAND
OPT	OPTICAL
ORG	ORGANIZATION
ORGS	ORGANIZATIONS
ORIG	ORIGINATION
OT	OVERTIME
OTN	OTHER-THAN-NEW
OUT	OUTPUT
OVFLO	OVERFLOW
PAR	PARAMETER
PARA	PARAGRAPH
PATN	PATTERN
PEM	PHOTOELECTROMAGNETIC
PHT	PHOTOTUBE
PKD	PACKED
PLANCODE	PLANNING
PO	PARTITIONED
POS	POSITIVE
PP	PAGES
PP	PRE-PROCESSOR
PR	PRINT
PRELIM	PRELIMINARY
PRM	PRIMARY
PROC	PROCEDURE
PROC	PROCESSOR
PROF	PROFESSION
PROG	PROGRAM
PRT	PRINTER
PRT	PRINT
PRTY	PRIORITY
PS	PICO-SECONDS
PSEC	PICOSECOND
QIL	QUAD-INLINE
QTY	QUANTITY
R-S	RESET-SET
R/W	READ/WRITE
RCV	REVOLVE
RCVR	RECEIVER
RD	READ
RDR	READER
RDY	READY
REC	RECORD
REF	REFERENCE
REG	REGISTER
REL	RELEASE
REM	REMAINDER
RPT	REPORT
SEC	SECOND
SECT	SECTION
SEG	SEGMENT
SEL	SELECT
SEQ	SEQUENCE
SERV	SERVICE
SIG	SIGNAL
SIM	SIMULATION
SPKR	SPEAKER
ST	START
STD	STANDARD
STOR	STORAGE
SYN	SYNCHRONOUS
SYNC	SYNCHRONIZE
TB	TERABYTES
TBL	TABLE
TP	TAPE
TX	TRANSMIT
UT	UTILITY
VAR	VARIABLE
VC	VISICALC
VOL	VOLUME
VW	VOLKSWRITER
WD	WORD
WR	WRITE
XFER	TRANSFER
XMIT	TRANSMIT
XTAL	CRYSTAL
YR	YEAR
YY	YEAR